Morphemes:
	-ir  = Owner indicator
	-af   = Plural form
	
	-a = Present tense
	-had  = Past tense

	-ikor = tion, sion

Sounds: Speak it like english

Words:
	Na = I, me, my
	Rol = You
	Ven = He, his, male pronoun
	Ver = She, her, female pronoun
	Va = It
	Ot = Is, am, be
	Vo = The
	Vor = That
	Lov = This
	Tof = They, them, their
	Len = And
	Jo = Or
	Folen = Will, future tense
	Nav = Name
	Ojan = Of
	Hol = Can
	Nolv = Not
	Dun = To
	Od = A, an
	Din = For
	Vold = Think
	Por = For

	Senva = Man
	Hanva = Woman

	Manakon = Enemy
	Verat = Start
	Dov = Stop

	Tivargat = Connect

	Sird = Wait

	Rotorgavik = Robot
	Avtit = Automatic

	Tor = Do
	Buk = Make

	Durst = War
	Lors = Battle, fight

	Særin = Ship, spaceship

	Vak = Die
	Likvot = Kill
	Vaknon = Death

	Nosen = Soldier, troop, infantry

	Janholva = Victory, win
	Voton = Lose, defeat

	Jæmor = King, emperor
	Jal = Hail, bow down to

	Evner = Greeting

	Lovmor = Leader

	Yal = Yes
	Nuv = No

	Vun = What
	Lun = Why

	Kos = Big
	Lis = Small

	Wrel = Very

	Alk = Wood
	Gulv = Stone
	Shar = Metal